---WWWWWWWWW---
---------------
--I-----I------
---------------
----P----------
---------------
---------------
------E--------
---------------
-----WWWWWW----
--------I------
---I-----------
---------------
-----------I---
---------------